WWWWWWWWWWWWWWWWWWWWWWWWW
W        1              W
W W W   W W W   W W W W W
W     w                wW
W W W W W W   W W WwW W W
W     w                 W
W W WwW W 5 W W W W W w W
W     w            w    W
W W W   W W W W   WwW W W
W      w      w         W
W W W W W W     W W W W W
W  4      w             W
W W W W W W W W W W WwW W
W      w         w     3W
WWWWWWWWWWWWWWWWWWWWWWWWW