WWWWWWWWWWWWWWWWWWWWWWWWW
W1                      W
W W W W W WwW W W W W W W
W                  w    W
W W WwW W W W W W W W W W
W             w         W
W W W W W W W W W W W W W
W         w             W
W W WwW W W W W W WwW W W
W                 w     W
W W W W WwW W W W W W W W
W             w         W
W W W W W W W W W W WwW W
W4                     3W
WWWWWWWWWWWWWWWWWWWWWWWWW