WWWWWWWWWWWWWWWWWWWWWWWWW
W        1           w  W
W W W   W W W   W W W W W
W  w                    W
W W WW  W W WwW W W W W W
W                 w     W
W W W WW  5 W W W W W   W
W   w                   W
W W W   W W W W   WwW W W
W                       W
W W WW W  W w   W W W W W
W  4           w        W
W W W W W  W W W WW WwW W
W                      3W
W W W W W   wW W W WW W W
W     w                 W
W W WW W W W     W WW W W
W                     w W
W W W W W W W   6   W W W
W     w                 W
WWWWWWWWWWWWWWWWWWWWWWWWW